111111111
1C1111111
11PE11111
111111111
