111111111
1E1P0C001
111111111
