11111111
1EE00001
10000001
11111001
11111P11
11111111
