111111111111111111
11P10000CC111100E1
11010000CC11110001
110100000011110001
100000000000000001
100000000000000001
100000000000000001
111111111111111111
