11111111111111111111
1P1C0010CCC000000111
1010101E1111111100C1
100010111C1C00000111
11111000001011010101
1C1000111C1C01C10001
101C111C10010101C1C1
10000000110001000101
11111111111111111111
